11111111111111111111111111111111111
1000000000000000000000000P1C0000001
10111111101111101111101011111111101
10000C1C001010001H1C101000000000001
10111111111011101010111111101111101
100000001000001C0000100C101000001C1
10111110111010111111101110101010111
101C0000101010000010000000101C10001
10111111101010101111101010111110111
1000000000001010C010001010001000001
11111110101111101010111011111011101
100000001010001010100C1010001000101
10101111101110101011111010111011101
1010001C000010001010001000001010001
10111011101010101010101011111110111
100C10001H10101010001000001H00000E1
11111111111111111111111111111111111
